1 1 1 1 1 1 1 1 1 1 1 1 1 1 1 1 1 1 1 1
1 1 1 1 1 1 1 1 1 1 1 1 1 1 1 1 1 1 1 1
1 1 0 0 0 0 0 0 0 3 3 3 0 0 0 0 0 0 3 3
1 1 1 1 1 1 0 0 0 3 3 3 0 0 0 1 1 1 1 1
1 1 1 1 1 1 1 3 3 3 3 3 3 3 1 1 1 1 1 1
1 1 1 1 1 1 1 3 3 3 3 3 3 3 1 1 1 1 1 1
1 1 0 0 0 0 0 0 0 3 3 3 0 0 0 0 0 0 1 1
1 1 1 1 1 1 0 0 0 3 3 3 0 0 0 1 1 1 1 1
1 1 1 1 1 1 1 3 3 3 3 3 3 3 1 1 1 1 1 1 
1 1 1 1 1 1 1 3 3 3 3 3 3 3 1 1 1 1 1 1
1 1 0 0 0 0 0 0 0 1 1 1 0 0 0 0 0 0 1 1
1 1 3 1 1 1 0 0 0 1 1 1 0 0 0 2 2 2 1 1
1 1 3 1 1 1 1 1 1 1 1 1 1 1 1 2 2 2 1 1
1 1 3 1 1 1 1 1 1 1 1 1 1 1 1 2 2 2 1 1
1 1 3 1 1 0 0 0 0 0 0 0 0 0 0 2 2 2 1 1
1 1 3 0 0 0 0 0 0 0 0 0 0 0 0 0 0 2 1 1
1 1 3 1 1 1 1 1 1 1 1 1 1 1 1 1 1 1 1 1
1 1 3 1 1 1 1 1 1 1 1 1 1 1 1 1 1 1 1 1
1 1 3 1 1 1 1 0 0 0 0 0 0 1 1 1 1 1 1 1
1 1 3 1 1 1 1 0 1 1 1 1 1 1 1 1 1 1 1 4
END_MAP
Weapon,Last Whisper,40,4,8,19
END_ITEM
TargetMonster,Greater Murk Wolf,50,30,20,7,5
TargetMonster,Red Brambleback,50,30,20,16,8
RegularMonster,Blue Sentinel,80,30,20,5,17
END_MONSTER
0
