1 1 0 0 0 1 1 1 1 1 1 1 1 1 1 0 0 0 0 0
1 1 1 1 1 1 1 1 1 1 1 1 1 1 1 0 0 0 0 0
1 1 1 1 1 1 1 1 1 1 1 1 1 1 1 1 2 2 2 0
0 1 0 0 0 1 1 1 1 1 1 1 1 1 1 1 2 2 2 0
0 1 0 0 0 0 0 0 0 0 0 0 0 0 0 0 0 2 2 0
0 1 0 0 0 1 1 1 1 1 1 1 1 1 1 0 0 1 1 0
1 1 1 3 1 1 1 1 1 1 1 1 1 1 1 1 3 1 1 1
1 1 1 3 1 1 1 1 1 1 1 1 1 1 1 1 3 1 1 1
1 1 1 3 1 1 1 1 1 1 1 1 1 1 1 1 3 1 1 1
1 1 1 3 1 1 1 1 1 1 1 1 1 1 1 1 3 1 1 1
1 1 1 3 1 1 1 1 1 1 1 1 1 1 1 1 3 1 1 1
1 1 1 3 1 1 1 1 1 1 1 1 1 1 1 1 3 1 1 1
1 1 1 3 1 1 1 1 1 1 1 1 1 1 1 1 3 1 1 1 
1 1 1 3 1 1 1 1 1 1 1 1 1 1 1 1 3 1 1 1
1 1 1 0 0 1 1 1 1 1 1 1 1 1 1 0 0 1 1 1
3 3 3 0 0 3 3 3 3 3 3 3 3 3 3 0 0 1 1 1
1 1 1 1 3 1 1 1 1 1 1 1 1 1 1 1 1 2 2 2
1 0 0 0 3 1 1 1 1 1 1 1 1 1 1 1 1 2 2 2
1 0 0 0 3 1 1 1 1 1 1 1 1 1 1 1 1 2 2 2
1 1 1 1 3 1 1 1 1 1 1 1 1 1 1 1 1 2 2 4
END_MAP
END_ITEM
Boss,Dragon,200,40,20,5,10,10,False
END_MONSTER
1
