1 1 1 1 1 0 3 3 3 3 3 3 3 3 3 3 3 3 3 3
1 1 1 1 1 1 1 1 1 1 1 1 1 1 1 0 0 0 0 3
1 1 0 0 0 0 1 1 1 1 1 1 1 1 1 1 1 0 0 3
1 1 0 0 0 0 1 1 1 1 1 1 1 1 1 1 1 1 1 3
0 1 0 0 0 0 1 1 1 1 1 1 1 1 1 2 2 2 1 3
3 1 1 1 1 1 1 1 1 1 1 1 1 1 1 2 2 2 1 3
3 1 1 1 1 1 1 1 1 1 1 1 1 1 1 2 2 2 1 3
3 1 1 1 1 1 1 1 1 1 1 1 1 1 1 1 1 1 1 3
3 1 1 1 1 1 1 1 1 1 1 1 1 1 1 1 1 1 1 3
3 1 1 1 1 1 1 1 1 1 1 1 1 1 1 1 1 1 1 3
3 1 1 1 1 1 1 1 1 1 1 1 1 1 1 1 1 1 1 3
3 1 1 1 1 1 1 1 1 1 1 1 1 1 1 1 1 1 1 3
3 1 1 1 1 1 1 1 1 1 1 1 1 1 1 1 1 1 1 3
3 1 1 1 1 1 1 1 1 1 1 1 1 1 1 1 1 1 1 3
3 1 1 1 1 1 1 1 1 1 1 1 1 0 0 0 0 0 0 3
3 1 1 2 2 2 1 1 1 1 1 1 1 1 1 0 1 1 1 3
3 1 1 2 2 2 1 1 1 1 1 1 1 0 1 1 1 0 1 3
3 0 0 2 2 2 1 1 1 1 1 1 1 0 0 0 0 0 1 3
3 0 0 0 0 1 1 1 1 1 1 1 1 0 0 0 0 0 1 1
3 3 3 3 3 3 3 3 3 3 3 3 3 3 3 3 3 3 1 4
END_MAP
END_ITEM
Boss,Dragon,150,60,30,7,10,10,True
END_MONSTER
2
