1 1 1 1 1 1 1 3 3 3 3 3 3 3 3 3 3 3 3 3
1 1 1 1 1 1 1 1 1 1 1 1 1 1 1 1 1 1 1 3
3 0 0 0 0 0 0 0 0 1 1 0 0 0 0 0 0 0 0 3
3 2 1 1 1 1 1 1 1 1 1 1 1 1 1 1 1 1 1 3
3 0 1 1 1 1 1 1 1 1 1 1 1 1 1 1 1 1 0 3
3 0 1 1 1 1 1 1 1 1 1 1 1 1 1 1 1 1 0 3
3 0 1 1 1 1 1 1 1 1 1 1 1 1 1 1 1 1 0 3
3 2 1 1 1 1 1 1 1 1 1 1 1 1 1 1 1 1 2 3 
3 0 1 1 1 1 1 1 1 1 1 1 1 1 1 1 1 1 0 3
3 0 1 1 1 1 1 1 1 1 1 1 1 1 1 1 1 1 0 3
3 0 1 1 1 1 1 1 1 1 1 1 1 1 1 1 1 1 0 3
3 2 1 1 1 1 1 1 1 1 1 1 1 1 1 1 1 1 2 3
3 0 1 1 1 1 4 1 1 1 1 1 1 1 1 1 1 1 0 3 
3 0 1 1 1 1 1 1 1 1 1 1 1 1 1 1 1 1 0 3
3 0 1 1 1 1 1 1 1 1 1 1 1 1 1 1 1 1 0 3
3 2 1 1 1 1 1 1 1 1 1 1 1 1 1 1 1 1 2 3
3 0 1 3 3 3 3 3 3 3 3 3 3 3 3 3 1 1 0 3
3 0 1 1 1 1 1 1 1 1 1 1 1 1 1 1 1 1 0 3
3 0 1 1 1 1 1 1 1 1 1 1 1 1 1 1 1 1 0 3
3 3 3 3 3 3 3 3 3 3 3 3 3 3 3 3 3 3 3 3
END_MAP
END_ITEM
Boss,Dragon,200,20,20,6,10,10,True
END_MONSTER
2